"species"	"reg"
"Drosophila_adiastola"	"Bark"
"Drosophila_anomalipes"	"Bark"
"Drosophila_clavisetae"	"Bark"
"Drosophila_comatifemora"	"Bark"
"Drosophila_dissita"	"Bark"
"Drosophila_engyochraecae"	"Bark"
"Drosophila_glabriapex"	"Bark"
"Drosophila_hemipeza"	"Bark"
"Drosophila_heteroneura"	"Bark"
"Drosophila_kualapa"	"Bark"
"Drosophila_melanocephala"	"Bark"
"Drosophila_micromyia"	"Bark"
"Drosophila_murphyi"	"Bark"
"Drosophila_neopicta"	"Bark"
"Drosophila_nigribasis"	"Bark"
"Drosophila_nr_residua"	"Bark"
"Drosophila_ochracea"	"Bark"
"Drosophila_papaalai"	"Bark"
"Drosophila_planitibia"	"Bark"
"Drosophila_prolaticilia"	"Bark"
"Drosophila_sejuncta"	"Bark"
"Drosophila_setosimentum"	"Bark"
"Drosophila_silvestris"	"Bark"
"Drosophila_sproati"	"Bark"
"Drosophila_villosipedis"	"Bark"
"Scaptomyza_caliginosa"	"Flower"
"Drosophila_mimica"	"Fruit"
"Drosophila_nigella"	"Fungus"
"Drosophila_crucigera"	"Generalist"
"Drosophila_grimshawi"	"Generalist"
"Drosophila_punalua"	"Generalist"
"Scaptomyza_exigua"	"Generalist"
"Scaptomyza_hackmani"	"Generalist"
"Scaptomyza_intricata"	"Generalist"
"Scaptomyza_latitergum"	"Generalist"
"Scaptomyza_protensa"	"Generalist"
"Scaptomyza_tumidula"	"Generalist"
"Drosophila_adunca"	"Leaf"
"Drosophila_ancyla"	"Leaf"
"Drosophila_atroscutellata"	"Leaf"
"Drosophila_cracens"	"Leaf"
"Drosophila_diamphidiopoda"	"Leaf"
"Drosophila_diamphipoda"	"Leaf"
"Drosophila_flavibasis"	"Leaf"
"Drosophila_kambysellisi"	"Leaf"
"Drosophila_nanella"	"Leaf"
"Drosophila_pectinitarsus"	"Leaf"
"Drosophila_percnosoma"	"Leaf"
"Drosophila_perissopoda"	"Leaf"
"Drosophila_petalopeza"	"Leaf"
"Drosophila_prodita"	"Leaf"
"Drosophila_redunca"	"Leaf"
"Drosophila_tanythrix"	"Leaf"
"Drosophila_torula"	"Leaf"
"Drosophila_tricheatosa"	"Leaf"
"Drosophila_unicula"	"Leaf"
"Drosophila_waddingtoni"	"Leaf"
"Drosophila_hawaiiensis"	"Sap"
"Drosophila_picticornis"	"Sap"
"Scaptomyza_chauliodon"	"Spider"
"Drosophila_adventitia"	"Bark"
"Drosophila_aethostoma"	NA
"Drosophila_affinidisjun"	NA
"Drosophila_ambochila"	"Bark"
"Drosophila_antecedens"	"Leaf"
"Drosophila_apicipuncta"	"Bark"
"Drosophila_apodasta"	NA
"Drosophila_aquila"	"Bark"
"Drosophila_atroscutella"	NA
"Drosophila_attenuata"	"Generalist"
"Drosophila_balioptera"	"Leaf"
"Drosophila_barbata"	"Bark"
"Drosophila_basimacula"	"Leaf"
"Drosophila_basisetae"	NA
"Drosophila_basisetosa"	"Leaf"
"Drosophila_bipolita"	"Fungus"
"Drosophila_biseriata"	NA
"Drosophila_bostrycha"	"Bark"
"Drosophila_brevitarsus"	"Bark"
"Drosophila_brunneifrons"	"Leaf"
"Drosophila_canipolita"	NA
"Drosophila_capitata"	NA
"Drosophila_chaetocephal"	"Generalist"
"Drosophila_ciliaticrus"	"Bark"
"Drosophila_cilifera"	"Generalist"
"Drosophila_clavitibia"	NA
"Drosophila_claytonae"	NA
"Drosophila_cnecopleura"	"Leaf"
"Drosophila_conformis"	"Leaf"
"Drosophila_conspicua"	NA
"Drosophila_contorta"	NA
"Drosophila_craddockae"	"Bark"
"Drosophila_crassifemur"	NA
"Drosophila_cyrtoloma"	"Bark"
"Drosophila_dasycnemia"	"Leaf"
"Drosophila_desallei"	"Bark"
"Drosophila_differens"	"Bark"
"Drosophila_digressa"	"Bark"
"Drosophila_discreta"	"Bark"
"Drosophila_disjuncta"	"Bark"
"Drosophila_distinguenda"	"Bark"
"Drosophila_divaricata"	NA
"Drosophila_dolomata"	"Generalist"
"Drosophila_engyochracea"	NA
"Drosophila_eurypeza"	NA
"Drosophila_eximia"	NA
"Drosophila_expansa"	"Leaf"
"Drosophila_fasciculiset"	NA
"Drosophila_fastigata"	"Leaf"
"Drosophila_flexipes"	"Sap"
"Drosophila_forficata"	NA
"Drosophila_formella"	NA
"Drosophila_fulgida"	NA
"Drosophila_fundita"	"Leaf"
"Drosophila_fungiperda"	"Fungus"
"Drosophila_furcatarsus"	NA
"Drosophila_furvifacies"	NA
"Drosophila_fuscoamoeba"	"Bark"
"Drosophila_gradata"	"Sap"
"Drosophila_haleakalae"	NA
"Drosophila_hamifera"	NA
"Drosophila_hanaulae"	NA
"Drosophila_hexachaetae"	"Bark"
"Drosophila_hirtitarsus"	"Sap"
"Drosophila_hirtitibia"	"Bark"
"Drosophila_hystricosa"	NA
"Drosophila_iki"	"Fungus"
"Drosophila_imparisetae"	"Generalist"
"Drosophila_inciliata"	NA
"Drosophila_incognita"	NA
"Drosophila_inedita"	"Bark"
"Drosophila_infuscata"	"Bark"
"Drosophila_ingens"	NA
"Drosophila_insignita"	NA
"Drosophila_involuta"	"Generalist"
"Drosophila_ischnotrix"	"Generalist"
"Drosophila_kauluai"	"Fruit"
"Drosophila_kikalaeleele"	NA
"Drosophila_kikiko"	NA
"Drosophila_kokeensis"	NA
"Drosophila_konaensis"	"Bark"
"Drosophila_kraussi"	"Bark"
"Drosophila_kuhao"	"Bark"
"Drosophila_lanaiensis"	NA
"Drosophila_larifuga"	"Generalist"
"Drosophila_latigena"	"Bark"
"Drosophila_lauoho"	NA
"Drosophila_limitata"	"Bark"
"Drosophila_lineosetae"	NA
"Drosophila_longiperda"	NA
"Drosophila_longiseta"	"Leaf"
"Drosophila_malele"	NA
"Drosophila_medialis"	"Bark"
"Drosophila_melanocephal"	"Bark"
"Drosophila_melanoloma"	"Fungus"
"Drosophila_mitchelli"	NA
"Drosophila_moli"	NA
"Drosophila_montgomeryi"	"Bark"
"Drosophila_multiciliata"	NA
"Drosophila_musaphilia"	"Sap"
"Drosophila_neoperkinsi"	NA
"Drosophila_neutralis"	"Leaf"
"Drosophila_nigra"	NA
"Drosophila_nigritarsus"	NA
"Drosophila_nigrocirrus"	NA
"Drosophila_nr_alsophila"	NA
"Drosophila_nr_ancyla"	"Leaf"
"Drosophila_nr_basimacul"	"Leaf"
"Drosophila_nr_basimacul"	"Leaf"
"Drosophila_nr_basimacul"	"Leaf"
"Drosophila_nr_brunneise"	"Leaf"
"Drosophila_nr_dorsigera"	NA
"Drosophila_nr_expansa_1"	"Leaf"
"Drosophila_nr_fundita"	"Leaf"
"Drosophila_nr_hirtitars"	NA
"Drosophila_nr_humeralis"	NA
"Drosophila_nr_melanoped"	NA
"Drosophila_nr_perissopo"	"Leaf"
"Drosophila_nr_perissopo"	"Leaf"
"Drosophila_nr_perissopo"	"Leaf"
"Drosophila_nr_perissopo"	"Leaf"
"Drosophila_nr_perissopo"	"Leaf"
"Drosophila_oahuensis"	NA
"Drosophila_obatai"	"Bark"
"Drosophila_obscuripes"	NA
"Drosophila_ochrobasis"	"Generalist"
"Drosophila_ochropleura"	"Fungus"
"Drosophila_odontophallu"	"Bark"
"Drosophila_orphnopeza"	"Bark"
"Drosophila_orthofascia"	"Generalist"
"Drosophila_orthoptera"	"Leaf"
"Drosophila_paenehamifer"	"Bark"
"Drosophila_panoanoa"	NA
"Drosophila_papala"	"Bark"
"Drosophila_paraanthrax"	NA
"Drosophila_paracracens"	NA
"Drosophila_paucipuncta"	"Bark"
"Drosophila_paucitarsus"	NA
"Drosophila_paucula"	"Leaf"
"Drosophila_pectinitarsu"	"Leaf"
"Drosophila_pihulu"	NA
"Drosophila_pilimana"	"Bark"
"Drosophila_pilipa"	NA
"Drosophila_pohaka"	NA
"Drosophila_polita"	"Fungus"
"Drosophila_polliciforma"	NA
"Drosophila_poonia"	"Bark"
"Drosophila_primaeva"	"Bark"
"Drosophila_proceriseta"	NA
"Drosophila_propiofacies"	NA
"Drosophila_prostopalpis"	NA
"Drosophila_pullipes"	"Bark"
"Drosophila_pychnochaeta"	NA
"Drosophila_quasianomali"	"Bark"
"Drosophila_quasiexpansa"	"Leaf"
"Drosophila_recticilia"	"Sap"
"Drosophila_scitula"	NA
"Drosophila_seclusa"	"Leaf"
"Drosophila_setosifrons"	"Bark"
"Drosophila_silvarentis"	"Sap"
"Drosophila_sobrina"	"Generalist"
"Drosophila_sodomae"	"Bark"
"Drosophila_soonae"	"Sap"
"Drosophila_sordidapex"	"Leaf"
"Drosophila_sp_KNM_4"	NA
"Drosophila_sp_KNMa"	NA
"Drosophila_stigma"	NA
"Drosophila_substenopter"	"Bark"
"Drosophila_systenopeza"	"Leaf"
"Drosophila_tetraspilota"	NA
"Drosophila_toxacantha"	"Bark"
"Drosophila_trichaetosa"	"Leaf"
"Drosophila_truncipenna"	NA
"Drosophila_turbata"	"Sap"
"Drosophila_variabilis"	"Leaf"
"Drosophila_vesciseta"	"Bark"
"Drosophila_williamsi"	"Leaf"
"Drosophila_xenophaga"	"Leaf"
"Drosophila_yooni"	"Leaf"
"Scaptomyza_abrupta"	NA
"Scaptomyza_albovittata"	NA
"Scaptomyza_ampliloba"	NA
"Scaptomyza_amplilobus"	NA
"Scaptomyza_anomala"	NA
"Scaptomyza_apicata"	NA
"Scaptomyza_apiciguttula"	"Generalist"
"Scaptomyza_bryani"	"Spider"
"Scaptomyza_buccata"	NA
"Scaptomyza_connata"	NA
"Scaptomyza_crassifemur"	NA
"Scaptomyza_ctenophora"	NA
"Scaptomyza_cuspidata"	"Generalist"
"Scaptomyza_cyrtandrae"	"Leaf"
"Scaptomyza_decepta"	NA
"Scaptomyza_dentata"	NA
"Scaptomyza_devexa"	NA
"Scaptomyza_elmoi"	NA
"Scaptomyza_fastigata"	NA
"Scaptomyza_flava"	"Leaf"
"Scaptomyza_flava6"	"Leaf"
"Scaptomyza_frustulifera"	NA
"Scaptomyza_hamata"	NA
"Scaptomyza_hsui"	NA
"Scaptomyza_inflatus"	NA
"Scaptomyza_lobifera"	NA
"Scaptomyza_longisetosa"	NA
"Scaptomyza_magnipalpa"	"Spider"
"Scaptomyza_nasalis"	NA
"Scaptomyza_neosilvicola"	"Spider"
"Scaptomyza_nigrita"	"Leaf"
"Scaptomyza_nigrosignata"	"Generalist"
"Scaptomyza_nr_anomala"	NA
"Scaptomyza_nr_cuspidata"	"Generalist"
"Scaptomyza_nr_decepta"	NA
"Scaptomyza_nr_inflatus"	NA
"Scaptomyza_nr_lonchopte"	NA
"Scaptomyza_nr_longipect"	NA
"Scaptomyza_nr_longiseto"	NA
"Scaptomyza_nr_longiseto"	NA
"Scaptomyza_nr_mitchelli"	NA
"Scaptomyza_nr_mitchelli"	NA
"Scaptomyza_palata"	NA
"Scaptomyza_pallida"	NA
"Scaptomyza_pallifrons"	NA
"Scaptomyza_palmae"	"Flower"
"Scaptomyza_pusilla"	NA
"Scaptomyza_recava"	NA
"Scaptomyza_recta"	NA
"Scaptomyza_reducta"	NA
"Scaptomyza_remota"	NA
"Scaptomyza_scoloplichas"	"Bark"
"Scaptomyza_setosiscutel"	"Spider"
"Scaptomyza_silvicola"	NA
"Scaptomyza_sp_akalae"	NA
"Scaptomyza_sp_Elmomyza"	NA
"Scaptomyza_sp_neocyrtan"	NA
"Scaptomyza_trivittata"	NA
"Scaptomyza_umbrosa"	NA
"Scaptomyza_undulata"	NA
"Scaptomyza_vagabunda"	NA
"Scaptomyza_varia"	"Generalist"
"Scaptomyza_varifrons"	NA
"Scaptomyza_varipicta"	"Generalist"